abandon	negative
abash	negative
abas	negative
abat	negative
abdic	negative
aberr	negative
abhor	negative
abhorr	negative
abid	positive
abil	positive
abjectli	negative
abject	negative
abjur	negative
abl	positive
abnorm	negative
abolish	negative
abomin	negative
abound	positive
above-averag	positive
abov	positive
abrad	negative
abras	negative
abrupt	negative
abscond	negative
absenc	negative
absente	negative
absent-mind	negative
absolut	neutral
absolv	positive
absorb	neutral
absurdli	negative
absurd	negative
abund	positive
abus	negative
abysm	negative
abyss	negative
acced	positive
accentu	neutral
accept	positive
access	positive
accident	negative
acclaim	positive
acclam	positive
accolad	positive
accommod	positive
accomplish	positive
accordantli	positive
accord	positive
accost	negative
account	negative
accur	positive
accurs	negative
accusingli	negative
accus	negative
acerb	negative
achiev	positive
ach	negative
acknowledg	positive
acquit	positive
acridli	negative
acrid	negative
acrimoni	negative
activist	neutral
activ	positive
actual	neutral
acumen	positive
adamantli	negative
adam	negative
adapt	positive
addict	negative
adeptli	positive
adept	positive
adequ	positive
adher	positive
adhes	positive
admiringli	positive
admir	positive
admiss	positive
admit	positive
admittedli	positive
admonishingli	negative
admonish	negative
admonit	negative
adolesc	neutral
adoringli	positive
ador	positive
adrift	negative
adroitli	positive
adroit	positive
adulatori	positive
adul	positive
adulter	negative
advanc	positive
advantag	positive
adventuresom	positive
adventur	positive
adversari	negative
advers	negative
advic	positive
advis	positive
advocaci	positive
advoc	positive
affabl	positive
affection	positive
affect	negative
affect	neutral
affect	positive
affin	positive
affirm	positive
afflict	negative
affluenc	positive
affluent	positive
afford	positive
affront	negative
afloat	positive
afraid	negative
against	negative
aggrav	negative
aggress	negative
aggressor	negative
aggriev	negative
aghast	negative
agil	positive
agit	negative
agoni	negative
agonizingli	negative
agon	negative
agreeabl	positive
agreement	positive
agre	positive
aha	neutral
ailment	negative
ail	negative
aimless	negative
air	negative
air	neutral
ala	negative
alarmingli	negative
alarm	negative
alert	neutral
alien	negative
allai	positive
alleg	negative
allegor	neutral
allerg	negative
allevi	positive
allianc	neutral
alli	positive
allow	positive
all-tim	neutral
alluringli	positive
allur	positive
allus	neutral
almighti	positive
aloof	negative
alterc	negative
although	negative
altogeth	neutral
altruist	positive
amazingli	positive
amaz	positive
ambigu	negative
ambiti	positive
ambival	negative
ambush	negative
amelior	positive
amen	positive
amiabili	positive
amiabl	positive
amic	positive
amiss	negative
amiti	positive
amnesti	positive
amour	positive
amplifi	neutral
ampli	positive
ampl	positive
amput	negative
amusingli	positive
amus	positive
analyt	neutral
anarchi	negative
anarchist	negative
anarch	negative
anem	negative
angel	positive
anger	negative
angrili	negative
angri	negative
anguish	negative
animos	negative
anim	positive
annihil	negative
annoi	negative
annoyingli	negative
annoy	negative
anomali	negative
anomal	negative
antagonist	negative
antagon	negative
anti-american	negative
anti-isra	negative
anti-	negative
anti-occup	negative
antipathi	negative
anti-prolifer	negative
antiqu	negative
anti-semit	negative
anti-soci	negative
antithet	negative
anti-u	negative
anti-whit	negative
anxieti	negative
anxiou	negative
anxious	negative
anyhow	neutral
anywai	neutral
apathet	negative
apathi	negative
ap	negative
apocalyps	negative
apocalypt	negative
apologist	negative
apostl	positive
apotheosi	positive
appallingli	negative
appal	negative
appar	neutral
appeal	positive
appear	neutral
appeas	positive
applaud	positive
appreci	positive
apprehend	neutral
apprehens	negative
appropri	positive
approv	positive
aptitud	positive
aptli	positive
apt	positive
arbitrari	negative
arcan	negative
archaic	negative
ardent	positive
ardor	positive
arduou	negative
arduous	negative
argument	negative
argu	negative
aristocrat	positive
arous	positive
arrest	positive
arrogantli	negative
arrog	negative
articul	positive
artifici	negative
ascend	positive
ascertain	positive
asham	negative
asininin	negative
asinin	negative
askanc	negative
aspers	negative
aspir	positive
assail	negative
assassin	negative
assault	negative
assent	positive
assert	positive
assess	neutral
asset	positive
assidu	positive
assuag	positive
assumpt	neutral
assuredli	positive
assur	positive
astonishingli	positive
astonish	positive
astoundingli	positive
astound	positive
astrai	negative
astronom	neutral
astut	positive
asund	negative
asylum	positive
atroci	negative
atroc	negative
atrophi	negative
attack	negative
attain	positive
attent	positive
attest	positive
attitud	neutral
attract	positive
attun	positive
audaci	negative
audac	negative
auspici	positive
auster	negative
authent	positive
authoritarian	negative
authorit	positive
autocrat	negative
autonom	positive
avalanch	negative
avarici	negative
avaric	negative
aveng	negative
aver	positive
avers	negative
avidli	positive
avid	positive
avoid	negative
award	positive
awar	neutral
awesom	positive
awestruck	positive
awfulli	negative
awkward	negative
aw	negative
aw	positive
ax	negative
babbl	negative
babi	neutral
backbit	negative
backbon	positive
back	positive
backward	negative
badli	negative
bad	negative
bafflement	negative
baffl	negative
bait	negative
balanc	positive
balk	negative
banal	negative
bane	negative
banish	negative
bankrupt	negative
barbarian	negative
barbar	negative
bare	negative
bargain	positive
bar	negative
barren	negative
baseless	negative
bash	negative
basic	neutral
basic	positive
bask	positive
bastard	negative
baton	neutral
batter	negative
batti	negative
battlefield	negative
battleground	negative
battle-lin	negative
battl	negative
beacon	positive
bearish	negative
beastli	negative
beast	negative
beatifi	positive
beauteou	positive
beautifi	positive
beautifulli	positive
beauti	positive
bedlamit	negative
bedlam	negative
befit	positive
befoul	negative
befriend	positive
beggarli	negative
beggar	negative
beg	negative
beguil	negative
belabor	negative
belat	negative
beleagu	negative
belief	neutral
believ	neutral
believ	positive
beli	negative
belittl	negative
bellicos	negative
belliger	negative
belov	positive
bemoan	negative
bemus	negative
benefactor	positive
beneficiari	positive
benefici	positive
benefic	positive
benefit	positive
benevol	positive
benign	positive
bent	negative
berat	negative
bereav	negative
bereft	negative
berserk	negative
beseech	negative
beset	negative
besid	neutral
besieg	negative
besmirch	negative
bestial	negative
best-known	positive
best-perform	positive
best	positive
best-sel	positive
betrai	negative
betray	negative
better-known	positive
better	positive
better-than-expect	positive
bewail	negative
bewar	negative
bewilderingli	negative
bewilder	negative
bewild	negative
bewitch	negative
bia	negative
bias	negative
bicker	negative
bid-rig	negative
big	neutral
bitchi	negative
bitch	negative
bite	negative
bitingli	negative
bitterli	negative
bitter	negative
bizarr	negative
blabber	negative
blab	negative
blackmail	negative
black	negative
blah	negative
blameless	positive
blame	negative
blameworthi	negative
blandish	negative
bland	negative
blasphemi	negative
blasphem	negative
blast	negative
blatantli	negative
blatant	negative
blather	negative
bleakli	negative
bleak	negative
bleed	negative
blemish	negative
bless	positive
blindingli	negative
blind	negative
blindsid	negative
blissfulli	positive
bliss	positive
blister	negative
blith	positive
bloat	negative
blockhead	negative
block	negative
bloodi	negative
blood	negative
blood	neutral
bloodsh	negative
bloodthirsti	negative
bloom	positive
blossom	positive
blow	negative
blunder	negative
blunt	negative
blur	negative
blurt	negative
boast	negative
boast	positive
boggl	negative
bogu	negative
boil	negative
boister	negative
boldli	positive
bold	positive
bolster	positive
bombard	negative
bombast	negative
bomb	negative
bondag	negative
bonker	negative
bonni	positive
bonu	positive
boom	positive
boost	positive
boredom	negative
bore	negative
botch	negative
bother	negative
bothersom	negative
boundless	positive
bounti	positive
bowdler	negative
boycott	negative
brag	both
braggart	negative
bragger	negative
braini	positive
brain	positive
brainwash	negative
brashli	negative
brash	negative
brat	negative
bravado	negative
brave	positive
braveri	positive
brazenli	negative
brazen	negative
breach	negative
breakdown	negative
break	negative
break-point	negative
breakthrough	positive
breathless	positive
breathtakingli	positive
breathtak	positive
brighten	positive
bright	positive
brillianc	positive
brilliantli	positive
brilliant	positive
brimston	negative
brisk	positive
bristl	negative
brittl	negative
broad-bas	neutral
broad	positive
broke	negative
broken-heart	negative
brood	negative
brook	positive
brotherli	positive
browbeat	negative
bruis	negative
brusqu	negative
brutalis	negative
brutal	negative
brute	negative
brutish	negative
buckl	negative
bug	negative
bulki	negative
bulli	negative
bullish	positive
bull	positive
bullyingli	negative
bum	negative
bumpi	negative
bungler	negative
bungl	negative
bunk	negative
buoyant	positive
burden	negative
burdensom	negative
burn	negative
busi	negative
busybodi	negative
butcheri	negative
butcher	negative
byzantin	negative
cackl	negative
cajol	negative
calamit	negative
calam	negative
callou	negative
calm	positive
calumni	negative
cancer	negative
candid	positive
candor	positive
cannib	negative
capabl	positive
capit	positive
capitul	negative
caprici	negative
capsiz	negative
captiv	negative
captiv	positive
carefre	positive
careless	negative
care	positive
caricatur	negative
carnag	negative
carp	negative
cartoonish	negative
cartoon	negative
cash-strap	negative
castig	negative
casualti	negative
cataclysm	negative
catalyst	positive
catastroph	negative
catchi	positive
caustic	negative
cautionari	negative
cautiou	negative
cave	negative
ceaseless	neutral
celebratori	positive
celebr	positive
censur	negative
central	neutral
certainli	neutral
certain	neutral
certifi	neutral
chafe	negative
chaff	negative
chagrin	negative
challeng	negative
champion	positive
champ	positive
chant	neutral
chao	negative
chaotic	negative
charisma	negative
charismat	positive
chariti	positive
charit	positive
charmingli	positive
charm	positive
chasten	negative
chastis	negative
chast	positive
chatterbox	negative
chatter	negative
cheapen	negative
cheap	negative
cheater	negative
cheat	negative
cheeri	positive
cheerless	negative
cheer	positive
cherish	positive
cherub	positive
chic	positive
chide	negative
childish	negative
chilli	negative
chill	negative
chit	negative
chivalri	positive
chivalr	positive
choke	negative
choppi	negative
chore	negative
chronic	negative
chum	positive
civil	positive
claim	neutral
clamor	negative
clandestin	neutral
clariti	positive
clash	negative
classic	positive
cleanli	positive
clean	positive
cleans	positive
clear-cut	positive
clearer	positive
clearli	positive
clear	positive
clever	positive
clich	negative
cliqu	negative
clog	negative
close	negative
close	positive
cloud	negative
clout	positive
clumsi	negative
coars	negative
coax	positive
cocki	negative
coddl	positive
coercion	negative
coerciv	negative
coerc	negative
cogent	positive
cogit	neutral
cogniz	neutral
coher	positive
cohes	positive
coldli	negative
cold	negative
collaps	negative
collid	negative
collud	negative
collus	negative
color	positive
coloss	positive
comb	negative
comeback	positive
comedi	negative
come	positive
comfort	positive
comic	negative
commend	positive
commensur	positive
comment	neutral
commiser	negative
commit	positive
commodi	positive
commonplac	negative
commonsens	positive
commot	negative
compact	positive
compassion	positive
compass	positive
compat	positive
compel	negative
compel	positive
compens	positive
competit	positive
compet	positive
complac	negative
complain	negative
complaint	negative
complement	positive
complet	neutral
complex	negative
compliant	positive
complicit	negative
complic	negative
complimentari	positive
compliment	positive
comprehend	neutral
comprehens	positive
compromis	positive
compuls	negative
compulsori	negative
comrad	positive
conced	negative
conceit	negative
conceiv	positive
concern	negative
concern	neutral
concert	neutral
concess	negative
conciliatori	positive
concili	positive
conclus	positive
concret	positive
concur	positive
condemn	negative
condescendingli	negative
condescend	negative
condescens	negative
condol	negative
condon	positive
conduc	positive
confer	positive
confess	negative
confid	neutral
confid	positive
conflict	negative
confound	negative
confront	negative
confus	negative
confut	positive
congeni	positive
congest	negative
congratulatori	positive
congratul	positive
conjectur	neutral
conquer	positive
conscienc	neutral
conscienc	positive
conscienti	positive
conscious	neutral
consensu	positive
consent	positive
consequ	neutral
consider	neutral
consider	positive
consid	neutral
consist	positive
consol	positive
conspicu	negative
conspiraci	negative
conspiratori	negative
conspir	negative
constanc	positive
constern	negative
constitut	neutral
constrain	negative
constraint	negative
construct	positive
consumm	positive
consum	negative
contagi	negative
contamin	negative
contempl	neutral
contempt	negative
contemptu	negative
contend	negative
contenti	negative
content	negative
content	positive
continu	neutral
continu	positive
contort	negative
contradict	negative
contradictori	negative
contrari	negative
contraven	negative
contribut	positive
contriv	negative
controversi	negative
conveni	positive
convict	positive
convincingli	positive
convinc	positive
convolut	negative
co-oper	positive
cooper	positive
cope	negative
cordial	positive
cornerston	positive
correctli	positive
correct	neutral
correct	positive
corrod	negative
corros	negative
corrupt	negative
cost-effect	positive
costli	negative
cost-sav	positive
could	neutral
counterproduct	negative
coupist	negative
courag	positive
courteou	positive
courtesi	positive
courtli	positive
court	positive
coven	positive
covert	neutral
covet	both
covetingli	both
covet	negative
cowardli	negative
coward	negative
cow	negative
cozi	positive
crackdown	negative
crafti	negative
cramp	negative
cranki	negative
crass	negative
cravenli	negative
craven	negative
crave	positive
craze	negative
crazili	negative
crazi	negative
creativ	positive
credenc	positive
credibl	positive
credul	negative
crime	negative
crimin	negative
cring	negative
crippl	negative
crisi	negative
crisp	positive
critic	negative
crook	negative
cross	negative
crowd	negative
crude	negative
cruel	negative
cruelti	negative
crumbl	negative
crumpl	negative
crusad	positive
crush	negative
cry	negative
culpabl	negative
cumbersom	negative
cuplrit	negative
cure-al	positive
curiou	positive
curious	positive
curs	negative
cursori	negative
curt	negative
cuss	negative
cute	positive
cut	negative
cutthroat	negative
cynic	negative
damag	negative
damnabl	negative
damnat	negative
damn	negative
danc	positive
danger	negative
dangl	negative
dare	positive
daringli	positive
darken	negative
dark	negative
darl	positive
darn	negative
dash	negative
dash	positive
dastardli	negative
dastard	negative
dauntingli	negative
dauntless	positive
daunt	negative
dawdl	negative
dawn	positive
daydream	positive
daze	negative
dazzl	positive
deadbeat	negative
deadli	negative
deadlock	negative
dead	negative
deadweight	negative
deaf	negative
deal	positive
dear	positive
dearth	negative
death	negative
debacl	negative
debas	negative
debat	negative
debaucheri	negative
debauch	negative
debilit	negative
debil	negative
decad	negative
decai	negative
deceitfulli	negative
deceit	negative
deceiv	negative
decenc	positive
decent	positive
decept	negative
decid	neutral
decis	positive
declaim	negative
declin	negative
decreas	negative
decrement	negative
decrepit	negative
decrepitud	negative
decri	negative
dedic	positive
deduc	neutral
deepen	negative
deepli	neutral
deep	negative
deep	neutral
defamatori	negative
defam	negative
defeat	negative
defect	negative
defend	positive
defens	negative
defens	positive
defer	positive
defianc	negative
defiantli	negative
defiant	negative
defici	negative
defil	negative
defi	negative
definit	positive
deflationari	positive
deform	negative
defraud	negative
deft	positive
defunct	negative
degener	negative
degradingli	negative
degrad	negative
dehuman	negative
deign	negative
dejectedli	negative
deject	negative
delect	positive
delicaci	positive
delici	positive
delic	positive
delightfulli	positive
delight	positive
delinqu	negative
deliri	negative
delirium	negative
delud	negative
delug	negative
delusion	negative
delus	negative
demand	both
demean	negative
demis	negative
democrat	positive
demolish	negative
demon	negative
demoralizingli	negative
demor	negative
demystifi	positive
denial	negative
denigr	negative
deni	negative
denounc	negative
denunci	negative
depend	neutral
depend	positive
deplet	negative
deploringli	negative
deplor	negative
depravedli	negative
deprav	negative
deprec	negative
depressingli	negative
depress	negative
depriv	negative
derid	negative
deris	negative
derogatori	negative
desecr	negative
desert	negative
deservedli	positive
deserv	positive
desicc	negative
desir	positive
desol	negative
despairingli	negative
despair	negative
desper	negative
despic	negative
despis	negative
despit	negative
despoil	negative
despond	negative
despot	negative
destabilis	negative
destini	neutral
destini	positive
destin	positive
destitut	negative
destroi	negative
destroy	negative
destruct	negative
desultori	negative
deterior	negative
determin	positive
deter	negative
deterr	negative
detest	negative
detract	negative
detriment	negative
devastatingli	negative
devast	negative
deviat	negative
devilishli	negative
devilish	negative
devil	negative
devilri	negative
deviou	negative
devious	negative
devoid	negative
devote	positive
devot	positive
devout	positive
dexter	positive
dextrou	positive
diabol	negative
diametr	negative
diatrib	negative
dictat	negative
dictatori	negative
differ	negative
differ	neutral
difficulti	negative
difficult	negative
diffid	negative
dig	negative
dignifi	positive
digniti	positive
dig	positive
digress	negative
dilapid	negative
dilemma	negative
dilig	positive
dilly-d	negative
diminish	negative
dim	negative
dinki	negative
din	negative
diplomaci	neutral
diplomat	positive
direct	neutral
dire	negative
dirti	negative
dirt	negative
disabl	negative
disaccord	negative
disadvantag	negative
disaffect	negative
disaffirm	negative
disagre	negative
disagr	negative
disallow	negative
disappointingli	negative
disappoint	negative
disapprob	negative
disapprov	negative
disarm	negative
disarrai	negative
disast	negative
disastr	negative
disavow	negative
disbelief	negative
disbeliev	negative
discern	neutral
discern	positive
disclaim	negative
discombobul	negative
discomfititur	negative
discomfit	negative
discomfort	negative
discompos	negative
disconcertingli	negative
disconcert	negative
disconsol	negative
discontentedli	negative
discontinu	negative
discont	negative
discord	negative
discounten	negative
discouragingli	negative
discourag	negative
discourt	negative
discredit	negative
discreet	positive
discrep	negative
discret	positive
discriminatingli	positive
discriminatori	negative
discrimin	negative
discrimin	positive
disdainfulli	negative
disdain	negative
diseas	negative
disfavor	negative
disgracefulli	negative
disgrac	negative
disgruntl	negative
disgustedli	negative
disgustfulli	negative
disgustingli	negative
disgust	negative
dishearteningli	negative
dishearten	negative
dishonesti	negative
dishonestli	negative
dishonest	negative
dishonor	negative
disillus	negative
disinclin	negative
disingenu	negative
disintegr	negative
disinterest	negative
dislik	negative
disloc	negative
disloyalti	negative
disloy	negative
dismai	negative
dismal	negative
dismayingli	negative
dismiss	negative
disobedi	negative
disobei	negative
disorderli	negative
disord	negative
disorgan	negative
disori	negative
disown	negative
disparagingli	negative
disparag	negative
dispens	negative
dispiritedli	negative
dispirit	negative
displac	negative
displeas	negative
displeasur	negative
disposit	neutral
disproportion	negative
disprov	negative
disput	negative
disquietingli	negative
disquiet	negative
disquietud	negative
disregard	negative
disreput	negative
disrespectabl	negative
disrespectfulli	negative
disrespect	negative
disrupt	negative
dissatisfact	negative
dissatisfactori	negative
dissatisfi	negative
dissembl	negative
dissens	negative
dissent	negative
disservic	negative
dissid	negative
dissoci	negative
dissolut	negative
dissonantli	negative
disson	negative
dissuad	negative
dissuas	negative
distastefulli	negative
distast	negative
distinctli	neutral
distinct	positive
distinguish	positive
distort	negative
distract	negative
distraughtli	negative
distraught	negative
distressingli	negative
distress	negative
distrust	negative
disturbed-let	negative
disturbingli	negative
disturb	negative
disun	negative
disvalu	negative
diverg	negative
diversifi	positive
divid	negative
divin	positive
divis	negative
divorc	negative
dizzi	negative
dizzingli	negative
dizz	negative
dodder	negative
dodgei	negative
dodg	positive
doggedli	negative
dogmat	negative
dog	negative
doldrum	negative
domin	negative
domin	neutral
doom	negative
doomsdai	negative
dope	negative
dote	positive
dotingli	positive
doubtfulli	negative
doubtless	positive
doubt	negative
downbeat	negative
downcast	negative
downer	negative
downfallen	negative
downfal	negative
downgrad	negative
downheartedli	negative
downheart	negative
down	negative
downright	neutral
downsid	negative
drab	negative
draconian	negative
dracon	negative
dragon	negative
dragoon	negative
drain	negative
drama	negative
dramat	neutral
drastic	negative
dreadfulli	negative
dread	negative
dreami	positive
dreamland	positive
dream	positive
dreari	negative
driven	positive
drive	positive
drone	negative
droop	negative
drought	negative
drown	negative
drunkard	negative
drunken	negative
drunk	negative
dubiou	negative
dubious	negative
dubit	negative
dud	negative
dullard	negative
dull	negative
dumbfound	negative
dumb	negative
dummi	negative
dump	negative
dunc	negative
dungeon	negative
dupe	negative
durabl	positive
dusti	negative
duti	neutral
dwindl	negative
dynam	positive
dy	negative
eagerli	positive
eager	positive
earnestli	positive
earnest	positive
earsplit	negative
easier	positive
easiest	positive
easili	positive
easi	positive
eas	positive
easygo	positive
ebulli	positive
eccentr	negative
eclect	positive
econom	positive
ecstasi	positive
ecstat	positive
edgi	negative
edifi	positive
educ	positive
effect	neutral
effect	positive
effectu	positive
efficaci	positive
effici	positive
effigi	negative
effortlessli	positive
effortless	positive
effronteri	negative
effus	positive
egalitarian	positive
egocentr	negative
egomania	negative
ego	negative
egotist	negative
egot	negative
egregi	negative
ejacul	negative
elabor	neutral
elan	positive
elatedli	positive
elat	positive
election-rigg	negative
electrifi	positive
electrif	positive
elegantli	positive
eleg	positive
elev	positive
elig	positive
elimin	negative
elit	positive
eloqu	positive
els	neutral
emaci	negative
emancip	positive
emascul	negative
embarrassingli	negative
embarrass	negative
embattl	negative
embellish	positive
embodi	neutral
embolden	positive
embrac	positive
embroil	negative
emin	positive
emot	negative
emot	neutral
empathi	negative
empath	negative
emphasis	neutral
emphat	negative
empower	positive
empow	positive
empti	negative
enabl	positive
enchantingli	positive
enchant	positive
encouragingli	positive
encourag	positive
encroach	negative
endang	negative
endear	positive
endless	negative
endors	positive
endur	positive
enemi	negative
energet	positive
energ	positive
enerv	negative
enfeebl	negative
enflam	negative
engag	neutral
engag	positive
engross	neutral
engross	positive
engulf	negative
enhanc	positive
enjoin	negative
enjoi	positive
enjoy	positive
enlighten	positive
enliven	positive
enmiti	negative
ennobl	positive
enorm	negative
enough	neutral
enrag	negative
enrapt	positive
enraptur	positive
enrich	positive
enslav	negative
ensur	positive
entangl	negative
enterpris	positive
entertain	positive
enthral	positive
enthusiasm	positive
enthusiast	positive
enthus	positive
enticingli	positive
entic	positive
entir	neutral
entranc	positive
entrap	negative
entreatingli	positive
entreat	positive
entrench	neutral
entrust	positive
enviabl	positive
envi	negative
enviou	negative
envious	negative
envis	positive
epic	positive
epidem	negative
epitom	positive
equal	positive
equit	positive
equivoc	negative
erad	negative
eras	negative
erod	negative
eros	negative
errant	negative
errat	negative
err	negative
erron	negative
error	negative
error type=weaksubj len=1 word1=stringently pos1=adverb stemmed1=n priorpolarity=negative mpqapolarity=strongneg
erudit	positive
escapad	negative
eschew	negative
esoter	negative
especi	positive
essenti	positive
establish	positive
esteem	positive
estrang	negative
etern	negative
etern	positive
ethic	positive
eulog	positive
euphoria	positive
euphor	positive
evad	negative
evalu	neutral
evas	negative
evenli	positive
even	positive
event	positive
everlast	positive
evid	positive
evildo	negative
evil	negative
eviscer	negative
evoc	positive
exacerb	negative
exactli	neutral
exact	negative
exact	neutral
exagger	negative
exaltedli	positive
exaltingli	positive
exalt	positive
exasperatingli	negative
exasper	negative
exceedingli	positive
exceed	positive
excel	positive
exce	positive
exception	positive
except	positive
excess	negative
excitedli	positive
excited	positive
excitingli	positive
excit	positive
exclaim	negative
exclud	negative
exclus	negative
exclus	neutral
exclus	positive
excori	negative
excruciatingli	negative
excruci	negative
excus	negative
excus	positive
execr	negative
exemplari	positive
exemplar	positive
exhaust	negative
exhaust	positive
exhilaratingli	positive
exhilar	positive
exhort	negative
exil	negative
exoner	positive
exorbitantli	negative
exorbitant	negative
exorbit	negative
expans	positive
expect	neutral
expedi	negative
expel	negative
expens	negative
experienc	positive
expertli	positive
expert	positive
expir	negative
explicitli	positive
explicit	positive
explod	negative
exploit	negative
explos	negative
expos	negative
expound	neutral
express	neutral
express	positive
expropri	negative
expuls	negative
expung	negative
exquisit	positive
extempor	neutral
extens	neutral
extermin	negative
extinguish	negative
extol	positive
extort	negative
extran	negative
extraordinarili	positive
extraordinari	positive
extravagantli	negative
extravag	negative
extremist	negative
extrem	negative
exuberantli	positive
exuber	positive
exultingli	positive
exult	positive
eyebrow	neutral
fabric	negative
fabul	positive
faceti	negative
facilit	positive
fact	neutral
factual	neutral
fade	negative
fail	negative
failur	negative
faintheart	negative
faint	negative
fairli	positive
fair	positive
faithfulli	positive
faithless	negative
faith	positive
fake	negative
fallaci	negative
fall	negative
fallout	negative
falsehood	negative
falsifi	negative
fals	negative
falter	negative
fame	positive
familiar	neutral
famin	negative
famish	negative
famou	positive
famous	positive
fanatic	negative
fanat	negative
fanci	negative
fanci	positive
fanfar	positive
fantasi	positive
fantast	positive
farcical-yet-provoc	negative
farcic	negative
farc	negative
far-fetch	negative
farfetch	negative
far-reach	neutral
farsight	positive
fascinatingli	positive
fascin	positive
fascism	negative
fascist	negative
fashion	positive
fastest-grow	positive
fast-grow	positive
fastidi	negative
fast	neutral
fast-pac	positive
fastuou	negative
fatalist	negative
fatal	negative
fatefulli	negative
fate	negative
fathomless	negative
fathom	positive
fatigu	negative
fat	negative
fatti	negative
fatuiti	negative
fatuou	negative
fatuous	negative
faulti	negative
fault	negative
favorit	positive
favor	positive
favour	positive
fawn	both
fawningli	negative
faze	negative
fearfulli	negative
fearlessli	positive
fearless	positive
fear	negative
fearsom	negative
feasibl	positive
featli	positive
feat	positive
feckless	negative
feeblemind	negative
feebl	negative
feel	neutral
feign	negative
feint	negative
feisti	positive
felicit	positive
felic	positive
fell	negative
feloni	negative
felon	negative
felt	neutral
feroci	negative
feroc	negative
fertil	positive
fervent	positive
fervidli	positive
fervid	positive
fervor	positive
festiv	positive
fetid	negative
feverish	negative
fever	negative
fiasco	negative
fiat	negative
fibber	negative
fib	negative
fickl	negative
fiction	negative
fictiti	negative
fidel	positive
fidgeti	negative
fidget	negative
fiendish	negative
fiend	negative
fierc	negative
fieri	positive
fight	negative
figurehead	negative
filthi	negative
filth	negative
finagl	negative
final	neutral
fine	negative
fine	positive
firmli	neutral
firm	neutral
first-class	positive
first-rat	positive
fissur	negative
fist	negative
fit	positive
fixer	neutral
flabbergast	negative
flag	negative
flagrantli	negative
flagrant	negative
flair	positive
flakei	negative
flake	negative
flaki	negative
flak	negative
flame	positive
flashi	negative
flash	negative
flat-out	negative
flatteringli	positive
flatter	positive
flaunt	negative
flawlessli	positive
flawless	positive
flaw	negative
fleer	negative
fleet	negative
flexibl	positive
flighti	negative
flimflam	negative
flimsi	negative
flirti	negative
flirt	negative
floor	negative
floor	neutral
flounder	negative
flourish	positive
flout	negative
fluent	positive
fluster	negative
foe	negative
fondli	positive
fond	positive
foolhardi	negative
foolishli	negative
foolish	negative
fool	negative
foolproof	positive
forbidden	negative
forbid	negative
forc	negative
forebodingli	negative
forebod	negative
foremost	positive
foresight	positive
foretel	neutral
forfeit	negative
forgav	positive
forgetfulli	negative
forget	negative
forgiven	positive
forgivingli	positive
forgiv	positive
forg	negative
forlornli	negative
forlorn	negative
formid	negative
forsaken	negative
forsak	negative
forse	neutral
forswear	negative
forthright	neutral
fortitud	positive
fortress	neutral
fortuit	positive
fortun	positive
foulli	negative
foul	negative
fractiou	negative
fractious	negative
fractur	negative
fragil	negative
fragment	negative
fragrant	positive
frail	negative
frankli	neutral
frank	positive
franticli	negative
frantic	negative
fratern	negative
fraud	negative
fraudul	negative
fraught	negative
frazzl	negative
freakishli	negative
freakish	negative
freak	negative
freedom	positive
free	positive
frenet	negative
frenzi	negative
frequent	neutral
fresh	positive
fret	negative
friction	negative
friendli	positive
friend	positive
friendship	positive
friggin	negative
frighteningli	negative
frighten	negative
frightfulli	negative
fright	negative
frigid	negative
frivol	negative
frolic	positive
frown	negative
frozen	negative
fruitlessli	negative
fruitless	negative
fruit	positive
frustratingli	negative
frustrat	negative
fudg	negative
fugit	negative
fulfil	positive
full-blown	negative
full-fledg	positive
fulli	neutral
full	neutral
full-scal	neutral
fulmin	negative
fumbl	negative
fume	negative
function	positive
fundament	negative
fundament	neutral
fund	neutral
fun	negative
funni	positive
fun	positive
furi	negative
furiou	negative
furious	negative
furor	negative
furthermor	neutral
further	neutral
fussi	negative
fuss	negative
fustig	negative
fusti	negative
futil	negative
fuzzi	negative
gabbl	negative
gaff	negative
gaga	negative
gaggl	negative
gaieti	positive
gaili	positive
gainfulli	positive
gain	positive
gainsai	negative
gainsay	negative
gallantli	positive
gallant	positive
gallingli	negative
gall	negative
galor	positive
galvan	neutral
gambl	negative
game	negative
gape	negative
garbag	negative
garish	negative
gasp	negative
gauch	negative
gaudi	negative
gawki	negative
gawk	negative
geezer	negative
gem	positive
generos	positive
gener	positive
genial	positive
geniu	positive
genocid	negative
gentl	positive
genuin	positive
german	positive
gestur	neutral
get-rich	negative
ghastli	negative
ghetto	negative
giant	neutral
gibberish	negative
gibber	negative
gibe	negative
giddi	positive
gift	positive
gigant	neutral
gladden	positive
gladli	positive
glad	positive
glamor	positive
glare	negative
glaringli	negative
glean	neutral
gleefulli	positive
gleeful	positive
glee	positive
glibli	negative
glib	negative
glimmer	positive
glisten	positive
glitch	negative
glitter	positive
gloat	both
gloatingli	negative
gloomi	negative
gloom	negative
glorifi	positive
gloriou	positive
glorious	positive
glori	positive
glossi	positive
gloss	negative
glower	negative
glowingli	positive
glow	positive
glum	negative
glut	negative
gnaw	negative
goad	negative
go-ahead	positive
god-aw	negative
goddam	negative
goddamn	negative
god-given	positive
godlik	positive
golden	positive
gold	positive
goodli	positive
good	positive
goodwil	positive
goof	negative
gorgeou	positive
gorgeous	positive
gossip	negative
gracefulli	positive
gracelessli	negative
graceless	negative
grace	positive
graciou	positive
gracious	positive
graft	negative
grail	positive
grandeur	positive
grandios	negative
grand	positive
grappl	negative
gratefulli	positive
grate	negative
grate	positive
gratifi	positive
gratif	positive
gratifyingli	positive
gratitud	positive
gratuit	negative
grave	negative
greatest	positive
greatli	neutral
great	positive
greedi	negative
greed	negative
greet	positive
grief	negative
grievanc	negative
griev	negative
grievou	negative
grievous	negative
grill	negative
grimac	negative
grim	negative
grind	negative
grin	positive
gripe	negative
grisli	negative
grit	positive
gritti	negative
groov	positive
grossli	negative
gross	negative
grotesqu	negative
grouchi	negative
grouch	negative
groundbreak	positive
groundless	negative
grous	negative
growl	negative
grow	neutral
grudgingli	negative
grudg	negative
gruesom	negative
gruff	negative
grumbl	negative
guarante	positive
guardian	positive
guidanc	positive
guil	negative
guiltili	negative
guilti	negative
guiltless	positive
guilt	negative
gullibl	negative
gumption	positive
gush	positive
gusto	positive
gutsi	positive
haggard	negative
haggl	negative
hail	positive
halcyon	positive
hale	positive
halfheartedli	negative
halfheart	negative
halfwai	neutral
hallow	positive
hallucin	negative
halt	neutral
hamper	negative
hamstr	negative
hamstrung	negative
handicap	negative
handili	positive
handi	positive
handsom	positive
hanker	positive
haphazard	negative
hapless	negative
happili	positive
happi	positive
harangu	negative
harass	negative
harbor	negative
hardbal	negative
harden	negative
hardhead	negative
hardheart	negative
hard-hit	negative
hardier	positive
hardi	positive
hardli	negative
hard-lin	negative
hardlin	negative
hard	negative
hardship	negative
hard-work	positive
harmless	positive
harm	negative
harmoni	positive
harmon	positive
harpi	negative
harridan	negative
harri	negative
harrow	negative
harshli	negative
harsh	negative
hassl	negative
hasti	negative
hast	negative
hatefulli	negative
hate	negative
hater	negative
hatr	negative
haughtili	negative
haughti	negative
haunt	negative
haven	positive
havoc	negative
hawkish	negative
hazard	negative
hazi	negative
headach	negative
headi	positive
headwai	positive
heal	positive
healthi	positive
health	positive
heartbreakingli	negative
heartbreak	negative
hearten	positive
heartfelt	positive
heartili	positive
heartless	negative
heart	positive
heartrend	negative
heartwarm	positive
heathen	negative
heavenli	positive
heaven	positive
heavili	negative
heavy-duti	neutral
heavy-hand	negative
heavyheart	negative
heckl	negative
heck	negative
hectic	negative
hedg	negative
hedonist	negative
heedless	negative
hefti	neutral
hegemoni	negative
hegemonist	negative
hegemon	negative
heinou	negative
hell-bent	negative
hellion	negative
hell	negative
helplessli	negative
helpless	negative
help	positive
herald	positive
heresi	negative
heret	negative
heroic	positive
heroin	positive
heroiz	positive
hero	positive
hesit	negative
hideou	negative
hideous	negative
highlight	positive
high	neutral
high-pow	neutral
high-qual	positive
hilari	positive
hilar	positive
hinder	negative
hindranc	negative
histor	positive
hmm	neutral
hm	neutral
hoard	negative
hoax	negative
hobbl	negative
hole	negative
holi	positive
hollow	negative
homag	positive
honesti	positive
honestli	positive
honest	positive
honeymoon	positive
honor	positive
hoodwink	negative
hopefulli	positive
hopelessli	negative
hopeless	negative
hope	positive
hord	negative
horrend	negative
horribl	negative
horrid	negative
horrifi	negative
horrif	negative
horrifyingli	negative
horror	negative
hospit	positive
hostag	negative
hostil	negative
hotb	negative
hothead	negative
hothous	negative
hot	positive
howev	neutral
hubri	negative
huckster	negative
huge	neutral
hug	positive
humanist	positive
humankind	positive
human	positive
humbl	negative
humbl	positive
humili	negative
humil	positive
humor	positive
humour	positive
hunger	negative
hungri	negative
hurt	negative
hustler	negative
hypnot	neutral
hypocrisi	negative
hypocrit	negative
hysteria	negative
hyster	negative
ici	negative
idealist	positive
ideal	positive
idea	neutral
idioci	negative
idiot	negative
idl	negative
idol	positive
idyl	positive
ignit	neutral
ignobl	negative
ignomini	negative
ignor	negative
ill-advis	negative
ill-conceiv	negative
illegitim	negative
illeg	negative
ill-fat	negative
ill-favor	negative
illicit	negative
illiquid	negative
illiter	negative
ill-mann	negative
ill-natur	negative
ill	negative
illog	negative
ill-sort	negative
ill-temp	negative
ill-treat	negative
illuminati	positive
illumin	positive
ill-usag	negative
ill-us	negative
illus	negative
illusori	negative
illustri	positive
imaginari	negative
imagin	neutral
imagin	positive
imbal	negative
imbecil	negative
imbroglio	negative
immacul	positive
immateri	negative
immatur	negative
immedi	neutral
immens	neutral
immensur	neutral
immin	negative
immobil	negative
immoder	negative
immodest	negative
immor	negative
immov	negative
immun	neutral
impair	negative
imparti	positive
impass	negative
impass	positive
impass	weakneg
impati	negative
impeach	negative
impecc	positive
impedi	negative
imped	negative
impel	positive
impend	negative
impenit	negative
imperfectli	negative
imperfect	negative
imperialist	negative
imperil	negative
imperi	negative
imperi	positive
impermiss	negative
imper	neutral
imperson	negative
impertin	negative
imperturb	positive
impervi	positive
impetu	negative
impetu	positive
impieti	negative
imping	negative
impiou	negative
implac	negative
implaus	negative
implicit	neutral
implic	negative
impli	neutral
implod	negative
implor	both
imploringli	both
impolit	negative
importantli	positive
import	positive
importun	negative
imposit	negative
impos	negative
impossibl	negative
imposs	negative
impot	negative
impoverish	negative
impract	negative
imprecis	negative
imprec	negative
impregn	positive
impress	positive
imprison	negative
improb	negative
improperli	negative
improp	negative
improprieti	negative
improvis	positive
improv	positive
imprud	negative
impud	negative
impugn	negative
impuls	negative
impun	negative
impur	negative
inabl	negative
inaccess	negative
inaccuraci	negative
inaccur	negative
inact	negative
inadequaci	negative
inadequ	negative
inadver	negative
inadvis	negative
inalien	positive
inan	negative
inappropri	negative
inaptitud	negative
inapt	negative
inargu	neutral
inarticul	negative
inattent	negative
incap	negative
incauti	negative
incendiari	negative
incens	negative
incessantli	negative
incess	negative
incis	positive
incit	negative
incivil	negative
inclement	negative
inclin	positive
inclus	positive
incogniz	negative
incoher	negative
incommensur	negative
incompar	negative
incompat	negative
incompet	negative
incomplet	negative
incompli	negative
incomprehens	negative
inconceiv	negative
inconclus	negative
incongru	negative
inconsequenti	negative
inconsequ	negative
inconsider	negative
inconsist	negative
inconsol	negative
inconst	negative
incontest	positive
incontrovert	positive
inconveni	negative
incorrectli	negative
incorrect	negative
incorrig	negative
incorrupt	positive
increasingli	neutral
increas	neutral
incred	positive
incredul	negative
inculc	negative
indebt	positive
indecis	negative
indec	negative
indecorum	negative
indefatig	positive
indefens	negative
indefinit	negative
indel	negative
indel	positive
inde	neutral
independ	positive
indescrib	positive
indestruct	positive
indetermin	negative
indic	neutral
indiffer	negative
indignantli	negative
indig	negative
indign	negative
indirect	neutral
indiscern	negative
indiscreetli	negative
indiscreet	negative
indiscret	negative
indiscrimin	negative
indispens	positive
indispos	negative
indisput	positive
indistinct	negative
individu	positive
indoctrin	negative
indol	negative
indomit	positive
indubit	positive
indulg	negative
indulg	positive
industri	positive
ineffect	negative
ineffectu	negative
inefficaci	negative
ineffici	negative
ineleg	negative
inelig	negative
ineloqu	negative
ineptitud	negative
ineptli	negative
inept	negative
inequit	negative
inequ	negative
inertia	negative
inescap	negative
inessenti	negative
inestim	positive
inevit	negative
inexact	negative
inexcus	negative
inexor	negative
inexpens	positive
inexperienc	negative
inexperi	negative
inexpertli	negative
inexpert	negative
inexpi	negative
inexplain	negative
inexplic	negative
inextric	negative
infal	positive
infami	negative
infam	negative
infatu	both
infecti	neutral
infect	negative
inferior	negative
infer	neutral
infern	negative
infest	negative
infidel	negative
infiltr	negative
infirm	negative
inflammatori	negative
inflam	negative
inflationari	negative
inflat	negative
inflex	negative
inflict	negative
influenc	neutral
influenti	positive
inform	neutral
inform	positive
infract	negative
infring	negative
infuriatingli	negative
infuri	negative
ingeni	positive
ingenu	positive
inglori	negative
ingratiatingli	positive
ingrati	positive
ingratitud	negative
ingrat	negative
inher	neutral
inhibit	negative
inhospit	negative
inhuman	negative
inim	negative
iniquit	negative
iniqu	negative
injudici	negative
injuri	negative
injur	negative
injustic	negative
inkl	neutral
innoc	positive
innocu	positive
innov	positive
innuendo	negative
innumer	neutral
inoffens	positive
inopportun	negative
inordin	negative
inquisit	positive
insan	negative
insati	negative
insecur	negative
insensit	negative
insens	negative
insidi	negative
insightfulli	positive
insight	neutral
insight	positive
insignificantli	negative
insignific	negative
insincer	negative
insinu	negative
insist	positive
insoci	negative
insol	negative
insolv	negative
insouci	negative
inspir	positive
instabl	negative
instig	negative
instruct	positive
instrument	positive
insubordin	negative
insubstanti	negative
insuffer	negative
insuffici	negative
insular	negative
insultingli	negative
insult	negative
insupport	negative
insurmount	negative
insurrect	negative
intact	positive
integr	positive
intellig	positive
intend	neutral
intens	neutral
intent	neutral
interced	positive
interest	positive
interfer	negative
intermitt	negative
interrupt	negative
intimaci	positive
intimidatingli	negative
intimid	negative
intim	neutral
intim	positive
intoler	negative
intox	negative
intract	negative
intransig	negative
intric	positive
intriguingli	positive
intrigu	neutral
intrigu	positive
intrud	negative
intrus	negative
intuit	positive
inund	negative
invad	negative
invalid	negative
invalu	positive
invas	negative
invect	negative
inveigl	negative
invent	positive
invidi	negative
invigor	positive
invinc	positive
inviol	positive
invis	neutral
involuntarili	negative
involuntari	negative
invulner	positive
irat	negative
irk	negative
irksom	negative
ir	negative
ironi	negative
iron	negative
irration	negative
irrat	negative
irreconcil	negative
irredeem	negative
irreform	negative
irrefut	positive
irregardless	neutral
irregular	negative
irrelev	negative
irrepar	negative
irreplac	negative
irrepress	negative
irreproach	positive
irresist	positive
irresolut	negative
irresolv	negative
irrespons	negative
irretriev	negative
irrever	negative
irrevers	negative
irrit	negative
isol	negative
itch	negative
jabber	negative
jade	negative
jam	negative
jar	negative
jaundic	negative
jauntili	positive
jaunti	positive
jealou	negative
jealousi	negative
jealous	negative
jeeringli	negative
jeer	negative
jeopardi	negative
jeopard	negative
jerk	negative
jest	positive
jitteri	negative
jobless	negative
joi	positive
joke	positive
joker	negative
jollifi	positive
jolli	positive
jolt	negative
jovial	positive
joyfulli	positive
joyless	positive
joyou	positive
joyous	positive
joy	positive
jubilantli	positive
jubil	positive
judgement	neutral
judgment	neutral
judici	positive
jumpi	negative
junki	negative
junk	negative
justic	positive
justifi	positive
justif	positive
justli	positive
just	positive
juvenil	negative
kaput	negative
keenli	positive
keen	negative
keen	positive
kei	neutral
kemp	positive
kick	negative
kid	positive
killer	negative
killjoi	negative
kill	negative
kindli	positive
kind	positive
kingmak	positive
kiss	positive
knave	negative
knew	neutral
knife	negative
knock	negative
knowingli	neutral
knowledg	neutral
knowledg	positive
know	neutral
kooki	negative
kook	negative
lackadais	negative
lackei	negative
lacklust	negative
lack	negative
lacon	negative
lag	negative
lambast	negative
lame-duck	negative
lame	negative
lament	negative
languid	negative
languish	negative
languor	negative
lanki	negative
laps	negative
large-scal	neutral
larg	neutral
larg	positive
lark	positive
lascivi	negative
last-ditch	negative
lastli	neutral
laudabl	positive
laud	positive
laughabl	negative
laughingstock	negative
laugh	negative
laughter	negative
lavishli	positive
lavish	positive
law-abid	positive
lawbreak	negative
lawfulli	positive
lawless	negative
law	positive
lax	negative
lazi	negative
lead	positive
leakag	negative
leaki	negative
leak	negative
lean	positive
learn	neutral
learn	positive
least	negative
lecheri	negative
lecher	negative
lech	negative
lectur	negative
leech	negative
leeri	negative
leer	negative
left-lean	negative
legaci	neutral
legalist	neutral
legendari	positive
legitimaci	positive
legitim	positive
lenient	positive
less-develop	negative
lessen	negative
lesser-known	negative
lesser	negative
less-expens	positive
less	negative
letch	negative
lethal	negative
lethargi	negative
letharg	negative
leverag	positive
leviti	positive
lewdli	negative
lewd	negative
liabil	negative
liabl	negative
liar	negative
liber	positive
liberti	positive
licenti	negative
lie	negative
lier	negative
lifeblood	positive
lifeless	negative
lifelong	positive
life-threaten	negative
lighten	positive
light-heart	positive
light	positive
likabl	positive
likelihood	neutral
like	neutral
like	positive
likewis	neutral
limitless	neutral
limit	negative
limp	negative
li	negative
lionheart	positive
listless	negative
liter	positive
litigi	negative
little-known	negative
littl	negative
live	positive
lividli	negative
livid	negative
loathli	negative
loath	negative
loathsom	negative
lofti	positive
logic	positive
loneli	negative
lone	negative
lonesom	negative
longingli	negative
long	negative
look	neutral
loophol	negative
loot	negative
lorn	negative
lose	negative
loser	negative
loss	negative
lost	negative
lousi	negative
lovabl	positive
loveless	negative
loveli	positive
lovelorn	negative
love	positive
lover	positive
low-cost	positive
lower-pr	positive
lowli	negative
low	negative
low-rat	negative
low-risk	positive
loyal	positive
loyalti	positive
lucidli	positive
lucid	positive
luckier	positive
luckiest	positive
luckili	positive
lucki	positive
luck	positive
lucr	positive
ludicr	negative
lugubri	negative
lukewarm	negative
lull	negative
lumin	positive
lunatic	negative
lunat	negative
lurch	negative
lure	negative
lurid	negative
lurk	negative
lush	positive
lust	both
luster	positive
lustrou	positive
luxuri	positive
ly	negative
lyric	positive
macabr	negative
maddeningli	negative
madden	negative
madder	negative
madli	negative
madman	negative
mad	negative
magic	positive
magnanim	positive
magnet	positive
magnific	positive
magnifi	positive
majesti	positive
majest	positive
major	neutral
maladi	negative
maladjust	negative
malais	negative
malcont	negative
maledict	negative
malevol	negative
malici	negative
malic	negative
malign	negative
malodor	negative
maltreat	negative
manag	positive
maneuv	negative
mangl	negative
maniac	negative
mania	negative
manic	negative
manifest	positive
manipul	negative
manli	positive
mannerli	positive
mantra	neutral
margin	negative
mar	negative
martyrdom	negative
martyrdom-seek	negative
marvel	positive
massacr	negative
massiv	neutral
masterfulli	positive
masteri	positive
masterpiec	positive
master	positive
matchless	positive
matter	neutral
matur	positive
maverick	negative
mawkishli	negative
mawkish	negative
maxi-devalu	negative
maxim	positive
mayb	neutral
meager	negative
meaningless	negative
meaning	positive
mean	negative
mean	neutral
meddlesom	negative
meddl	negative
mediocr	negative
meek	positive
melancholi	negative
mellow	positive
melodramat	negative
memori	neutral
memori	positive
memor	positive
menacingli	negative
menac	negative
mendaci	negative
mendac	negative
mend	positive
menial	negative
mental	neutral
mentor	positive
mercifulli	positive
mercilessli	negative
merciless	negative
merci	positive
mere	negative
meritori	positive
merit	positive
merrili	positive
merriment	positive
merri	positive
mesmerizingli	positive
mesmer	positive
messi	negative
mess	negative
metaphor	neutral
meticul	positive
midget	negative
miff	negative
mightili	positive
mighti	positive
might	neutral
might	positive
mild	positive
milit	negative
mindlessli	negative
mindless	negative
mind	negative
mind	positive
minist	positive
minor	neutral
miracl	positive
miracul	positive
mirag	negative
mire	negative
mirth	positive
misapprehend	negative
misbecom	negative
misbegotten	negative
misbehavior	negative
misbehav	negative
miscalcul	negative
mischief	negative
mischiev	negative
misconcept	negative
miscreant	negative
misdirect	negative
miseri	negative
miserli	negative
miser	negative
misfit	negative
misfortun	negative
misgiv	negative
misguid	negative
mishandl	negative
mishap	negative
misinform	negative
misinterpret	negative
misjudg	negative
misleadingli	negative
mislead	negative
mislik	negative
mismanag	negative
misread	negative
misrepresent	negative
misrepres	negative
miss	negative
misstat	negative
mistakenli	negative
mistaken	negative
mistak	negative
mistifi	negative
mistrustfulli	negative
mistrust	negative
misunderstand	negative
misunderstood	negative
misus	negative
mm	neutral
moan	negative
mockeri	negative
mockingli	negative
mock	negative
modern	positive
moder	positive
modesti	positive
modest	positive
molest	negative
mollifi	positive
moment	positive
monotoni	negative
monoton	negative
monster	negative
monstros	negative
monstrou	negative
monstrous	negative
monument	positive
moodi	negative
moon	negative
moot	negative
mope	negative
moral	positive
morbidli	negative
morbid	negative
mordantli	negative
mordant	negative
moreov	neutral
moribund	negative
mortifi	negative
mortif	negative
mostli	neutral
most	neutral
motionless	negative
motiv	neutral
motiv	positive
motlei	negative
mourner	negative
mournfulli	negative
mourn	negative
move	neutral
move	positive
much	neutral
muddi	negative
muddl	negative
mudsling	negative
mulish	negative
multi-polar	negative
mum	neutral
mundan	negative
murder	negative
murki	negative
muscle-flex	negative
must	neutral
myriad	positive
mysteri	negative
mystifi	negative
myth	negative
nag	negative
naiv	negative
nap	neutral
narrow	negative
nascent	neutral
nastili	negative
nasti	negative
nation	negative
natur	neutral
natur	positive
naughti	negative
nauseatingli	negative
nauseat	negative
navig	positive
neatli	positive
neat	positive
nebul	negative
necessarili	positive
necessari	positive
needfulli	neutral
needi	negative
needlessli	negative
needless	negative
need	negative
need	neutral
nefari	negative
negat	negative
neglect	negative
neglig	negative
neg	negative
nemesi	negative
nervou	negative
nervous	negative
nettlesom	negative
nettl	negative
neurot	negative
neutral	positive
nevertheless	neutral
nice	positive
nifti	positive
niggl	negative
nightmarishli	negative
nightmarish	negative
nightmar	negative
nimbl	positive
nix	negative
nobli	positive
nobl	positive
noisi	negative
non-confid	negative
nonexist	negative
nonsens	negative
nonviol	neutral
non-viol	positive
normal	positive
nosei	negative
notabl	positive
noteworthi	positive
notic	positive
notion	neutral
notori	negative
nourish	positive
novel	positive
nuanc	neutral
nuisanc	negative
numb	negative
nurtur	positive
oasi	positive
obedi	positive
obei	positive
obes	negative
objection	negative
object	negative
object	positive
oblig	neutral
oblig	positive
obliqu	negative
obliter	negative
oblivi	negative
obnoxi	negative
obscen	negative
obscur	negative
obsess	negative
obsolet	negative
obstacl	negative
obstin	negative
obstruct	negative
obtrus	negative
obtus	negative
obviat	positive
obviou	neutral
obvious	negative
odder	negative
oddest	negative
odditi	negative
oddli	negative
odd	negative
offbeat	positive
offenc	negative
offend	negative
offens	negative
offici	negative
offset	positive
oh	neutral
okai	positive
olymp	neutral
omin	negative
omiss	negative
omit	negative
oner	negative
one-sid	negative
onslaught	negative
onward	positive
open-end	neutral
openli	positive
open	positive
opinion	negative
opinion	neutral
oppon	negative
opportunist	negative
opportun	positive
opposit	negative
oppos	negative
oppress	negative
oppressor	negative
optimist	positive
optim	positive
opul	positive
ordeal	negative
orderli	positive
origin	positive
orphan	negative
orthodoxi	neutral
ostrac	negative
ought	neutral
outbreak	negative
outburst	negative
outcast	negative
outcri	negative
outdat	negative
outdo	positive
outgo	positive
outlaw	negative
outlook	neutral
outmod	negative
outrag	negative
outright	neutral
outshin	positive
outsid	negative
outsmart	positive
outspoken	neutral
outstandingli	positive
outstand	positive
outstrip	positive
outwit	positive
ovat	positive
overachiev	positive
over-act	negative
overact	negative
overaw	negative
overbalanc	negative
overbal	negative
overbearingli	negative
overbear	negative
overblown	negative
overcom	negative
overdo	negative
overdon	negative
overdu	negative
overemphas	negative
overjoi	positive
overkil	negative
overlook	negative
overplai	negative
overpow	negative
overreach	negative
overrun	negative
overshadow	negative
oversight	negative
oversimplifi	negative
oversimplif	negative
overs	negative
overstat	negative
overst	negative
overtax	negative
overthrow	negative
overt	neutral
overtur	neutral
overturn	negative
overtur	positive
over-valu	negative
overwhelmingli	negative
overwhelm	negative
overwork	negative
overzeal	negative
pacifi	neutral
pacifist	positive
painfulli	negative
painlessli	positive
painless	positive
pain	negative
painstakingli	positive
painstak	positive
palati	positive
palat	positive
pale	negative
palliat	positive
paltri	negative
pamper	positive
pandemonium	negative
panicki	negative
panic	negative
pan	negative
paradis	positive
paradox	negative
paral	negative
paralyz	negative
paramount	positive
paranoia	negative
paranoid	negative
parasit	negative
pardon	positive
pariah	negative
parodi	negative
partial	negative
particularli	neutral
particular	neutral
partisan	negative
passion	positive
passiv	negative
pass	negative
pathet	negative
patienc	positive
patient	positive
patriot	positive
patron	negative
pauciti	negative
pauper	negative
payback	negative
peaceabl	positive
peacefulli	positive
peacekeep	positive
peac	positive
peculiarli	negative
peculiar	negative
pedant	negative
pedestrian	negative
peerless	positive
peevishli	negative
peevish	negative
peev	negative
penal	negative
penalti	negative
penetr	positive
penit	positive
percept	neutral
percept	positive
perfectli	positive
perfect	positive
perfidi	negative
perfid	negative
perfunctori	negative
perhap	neutral
peril	negative
peripher	negative
perish	negative
permiss	positive
pernici	negative
perplex	negative
persecut	negative
persever	positive
persist	neutral
persist	positive
personag	positive
person	positive
perspect	neutral
perspicu	positive
persuad	positive
persuas	positive
pertinaci	negative
pertinac	negative
pertin	positive
perturb	negative
pervas	negative
pervers	negative
pervert	negative
pessimist	negative
pessim	negative
pestil	negative
pest	negative
petrifi	negative
pettifog	negative
petti	negative
phenomen	positive
philosoph	neutral
phobia	negative
phobic	negative
phoni	negative
picki	negative
picturesqu	positive
pieti	positive
pillag	negative
pillar	positive
pillori	negative
pinch	negative
pine	negative
pinnacl	positive
piou	positive
piqu	negative
pithi	positive
pitiabl	negative
pitifulli	negative
pitilessli	negative
pitiless	negative
piti	negative
pittanc	negative
pivot	neutral
placat	positive
placid	positive
plagiar	negative
plagu	negative
plainli	positive
plain	positive
plausibl	positive
player	neutral
playfulli	positive
play	positive
playth	negative
plead	both
pleadingli	both
plea	negative
pleasantli	positive
pleasant	positive
pleasingli	positive
pleas	positive
pleasur	positive
plebeian	negative
pledg	positive
plenari	neutral
plenti	positive
plight	negative
ploi	negative
plot	negative
plotter	negative
plunder	negative
plush	positive
poetic	positive
poignant	positive
pointlessli	negative
pointless	negative
point	neutral
poison	negative
pois	positive
polaris	negative
polem	negative
polish	positive
polit	positive
pollut	negative
polut	negative
pompou	negative
ponder	neutral
poorli	negative
poor	negative
popular	positive
portabl	positive
posh	positive
posit	neutral
posit	positive
possibl	neutral
poster	positive
postur	negative
postur	neutral
potenti	positive
potent	positive
pout	negative
poverti	negative
powerfulli	positive
powerless	negative
power	neutral
power	positive
practic	neutral
practic	positive
pragmat	positive
prai	neutral
praiseworthi	positive
prais	positive
prate	negative
pratfal	negative
prattl	negative
preach	positive
precari	negative
precaut	positive
preced	positive
preciou	neutral
preciou	positive
precipit	negative
precis	positive
predatori	negative
predica	negative
predict	neutral
predomin	neutral
pre-emin	positive
preemin	positive
preemptiv	positive
prefer	positive
prejudg	negative
prejudici	negative
prejudic	negative
premedit	negative
premier	positive
premium	positive
preoccupi	negative
prepar	positive
preponder	positive
preposter	negative
press	negative
press	positive
pressur	neutral
prestigi	positive
prestig	positive
presum	negative
presum	neutral
presumptu	negative
pretenc	negative
pretend	negative
pretens	negative
pretenti	negative
prettili	positive
pretti	positive
preval	neutral
prevar	negative
pricei	negative
priceless	positive
prickl	negative
pride	negative
pride	positive
primarili	neutral
primari	neutral
prime	neutral
primit	negative
principl	positive
prison	negative
privileg	positive
prize	positive
proactiv	positive
pro-american	positive
pro-beij	positive
problemat	negative
problem	negative
proclaim	neutral
procrastin	negative
pro-cuba	positive
prodigi	positive
product	positive
profan	negative
profess	positive
profici	positive
profit	positive
profoundli	positive
profound	positive
profus	positive
prognost	neutral
progress	positive
prohibit	negative
prolif	positive
promin	positive
promis	positive
promot	positive
promptli	positive
prompt	positive
propaganda	negative
propagand	negative
pro-peac	positive
properli	positive
proper	positive
prophesi	neutral
propiti	positive
proportion	neutral
pro	positive
proscript	negative
prosecut	negative
prospect	positive
prosper	positive
protector	positive
protect	positive
protest	negative
protract	negative
proud	positive
prove	neutral
provid	positive
provoc	negative
provok	negative
prowess	positive
prudenc	positive
prudent	positive
pry	negative
pugnaci	negative
pugnac	negative
punch	negative
punctual	positive
pundit	positive
puni	negative
punish	negative
punit	negative
puppet	negative
pure	positive
purifi	positive
purif	positive
puriti	positive
purpos	positive
puzzlement	negative
puzzl	negative
quack	negative
quaint	positive
qualifi	positive
qualm	negative
quandari	negative
quarrel	negative
quarrelsom	negative
quash	negative
quasi-	positive
queer	negative
quench	positive
question	negative
quibbl	negative
quicken	positive
quick	neutral
quiet	neutral
quit	negative
quit	neutral
quitter	negative
racism	negative
racist	negative
rack	negative
radianc	positive
radiant	positive
radic	negative
rage	negative
rag	negative
rail	negative
ralli	positive
rampag	negative
rampant	negative
ramshackl	negative
rancor	negative
rankl	negative
rank	negative
rantingli	negative
rant	negative
rapid	neutral
rapport	positive
rapproch	positive
rapt	positive
raptur	positive
rare	neutral
rascal	negative
rash	negative
rather	neutral
ration	negative
ration	positive
rat	negative
rattl	negative
ravag	negative
rave	negative
rave	positive
reactionari	negative
reaction	neutral
react	neutral
readili	positive
readi	neutral
readi	positive
reaffirm	positive
realist	positive
realiz	neutral
realli	neutral
real	positive
reason	positive
reassur	positive
rebelli	negative
rebuff	negative
rebuk	negative
recalcitr	negative
recant	negative
recept	positive
recessionari	negative
recess	negative
recklessli	negative
reckless	negative
reclaim	positive
recognit	positive
recogniz	neutral
recoil	negative
recommend	positive
recompens	positive
reconcili	positive
reconcil	positive
re-conquest	positive
record-set	positive
recours	negative
recov	positive
rectifi	positive
rectif	positive
redeem	positive
redempt	positive
redund	negative
reestablish	positive
refin	positive
reflect	neutral
reform	positive
refresh	positive
refug	positive
refus	negative
refut	negative
regal	positive
regardlessli	neutral
regardless	neutral
regard	neutral
regard	positive
regress	negative
regretfulli	negative
regret	negative
regrett	negative
rehabilit	positive
reinforc	positive
reiter	neutral
reject	negative
rejoicingli	positive
rejoic	positive
relaps	negative
relat	neutral
relax	positive
relentlessli	negative
relentless	negative
relent	positive
relev	positive
reliabl	positive
relief	positive
reliev	positive
relish	positive
reluctantli	negative
reluct	negative
remark	neutral
remark	positive
remedi	positive
reminisc	positive
remorsefulli	negative
remorselessli	negative
remorseless	negative
remors	negative
remuner	positive
renaiss	positive
renew	neutral
renew	positive
renounc	negative
renov	positive
renown	positive
renunci	negative
repai	positive
repair	positive
repar	positive
repel	negative
repent	positive
repetit	negative
replet	neutral
reprehens	negative
repress	negative
reprimand	negative
reproach	negative
reprovingli	negative
reprov	negative
repudi	negative
repugnantli	negative
repugn	negative
repuls	negative
reput	neutral
reput	positive
rescu	positive
resent	negative
reserv	negative
resign	negative
resili	positive
resist	negative
resolut	positive
resolv	positive
resound	positive
resourc	positive
respectfulli	positive
respect	positive
respit	positive
resplend	positive
respons	positive
restless	negative
restor	positive
rest	positive
restraint	positive
restrict	negative
resurg	positive
retaliatori	negative
retali	negative
retard	negative
retic	negative
retir	negative
retract	negative
retreat	negative
reunit	positive
reveal	neutral
revelatori	neutral
revel	positive
revengefulli	negative
reveng	negative
rever	positive
revert	negative
revil	negative
revit	positive
reviv	positive
revok	negative
revoltingli	negative
revolt	negative
revolut	positive
revuls	negative
rewardingli	positive
reward	positive
rhapsod	negative
rhetor	negative
richli	positive
rich	positive
ridicul	negative
rid	negative
rife	negative
rift	negative
righten	positive
righteou	positive
righteous	positive
rightfulli	positive
rightli	positive
right	positive
rigid	negative
rigor	negative
rile	negative
ripe	positive
risk-fre	positive
riski	negative
risk	negative
rival	negative
rivalri	negative
roadblock	negative
robust	positive
rocki	negative
rogu	negative
rollercoast	negative
romantic	positive
romant	positive
rosi	positive
rot	negative
rotten	negative
rough	negative
rous	positive
rubbish	negative
rude	negative
rue	negative
ruffian	negative
ruffl	negative
ruin	negative
ruinou	negative
rumbl	negative
rumor	negative
rumour	negative
rumpl	negative
runawai	negative
run-down	negative
ruptur	negative
rusti	negative
ruthlessli	negative
ruthless	negative
sabotag	negative
sacrific	negative
sacr	positive
sadden	negative
sadli	negative
sad	negative
safeguard	positive
safe	positive
sagac	positive
sage	positive
sag	negative
saintli	positive
saint	positive
salabl	positive
salaci	negative
saliv	positive
salutari	positive
salut	positive
salvat	positive
sanctifi	positive
sanctimoni	negative
sanction	positive
sanctiti	positive
sanctuari	positive
sane	positive
sanguin	positive
saniti	positive
sap	negative
sarcasm	negative
sarcast	negative
sardon	negative
sass	negative
satir	negative
satisfactorili	positive
satisfactori	positive
satisfact	positive
satisfi	positive
savageri	negative
savag	negative
savor	positive
savvi	positive
scandal	negative
scant	negative
scapegoat	negative
scarciti	negative
scarc	negative
scare	negative
scarier	negative
scariest	negative
scarili	negative
scari	negative
scar	negative
scathingli	negative
scath	negative
scenic	positive
scheme	negative
scholarli	neutral
scoffingli	negative
scoff	negative
scoldingli	negative
scold	negative
scorchingli	negative
scorch	negative
scornfulli	negative
scorn	negative
scoundrel	negative
scourg	negative
scowl	negative
screamingli	neutral
scream	negative
scream	neutral
screech	negative
screw	negative
scrupl	positive
scrupul	positive
scrutini	neutral
scrutin	neutral
scummi	negative
scum	negative
seamless	positive
season	positive
second-class	negative
second-ti	negative
secret	negative
secur	positive
sedentari	negative
seduct	positive
seedi	negative
seemingli	neutral
seem	neutral
seeth	negative
select	positive
self-coup	negative
self-critic	negative
self-def	negative
self-destruct	negative
self-determin	positive
self-examin	neutral
self-humili	negative
self-interest	negative
selfinterest	negative
selfishli	negative
selfish	negative
self-respect	positive
self-satisfact	positive
self-serv	negative
self-suffici	positive
semblanc	positive
senil	negative
sensation	negative
sensation	positive
sensat	positive
senselessli	negative
senseless	negative
sensibl	positive
sensit	positive
sens	positive
sentiment	positive
seren	positive
seriou	negative
serious	negative
sermon	negative
servitud	negative
settl	positive
set-up	negative
sever	negative
sexi	positive
shabbi	negative
shadi	negative
shadowi	negative
shadow	negative
shake	negative
shaki	negative
shallow	negative
shambl	negative
shamefulli	negative
shamelessli	negative
shameless	negative
shame	negative
sham	negative
shark	negative
sharpli	negative
sharp	negative
shatter	negative
sheer	negative
shelter	positive
shield	positive
shimmeringli	positive
shimmer	positive
shine	positive
shini	positive
shipwreck	negative
shirker	negative
shirk	negative
shiver	negative
shockingli	negative
shock	negative
shoddi	negative
shortag	negative
shortchang	negative
shortcom	negative
short-liv	negative
shortsighted	negative
shortsight	negative
should	neutral
showdown	negative
show	neutral
shred	negative
shrewdli	positive
shrewd	positive
shrew	negative
shriek	negative
shrilli	negative
shrill	negative
shrivel	negative
shroud	negative
shrug	negative
shun	negative
shyli	negative
shy	negative
shyness	negative
sickeningli	negative
sicken	negative
sickli	negative
sick	negative
sidetrack	negative
sieg	negative
signal	neutral
signific	positive
signifi	positive
sillili	negative
silli	negative
simmer	negative
simplic	positive
simplifi	positive
simpli	neutral
simplist	negative
simpl	positive
sincer	positive
sinfulli	negative
sinisterli	negative
sinist	negative
sink	negative
sin	negative
skeleton	negative
skeptic	negative
sketchi	negative
skillfulli	positive
skill	positive
skimpi	negative
skittishli	negative
skittish	negative
skulk	negative
slack	negative
slander	negative
slap	negative
slash	negative
slaughter	negative
slave	negative
sleazi	negative
sleek	positive
sleepi	neutral
slender	positive
slightli	negative
slight	negative
slime	negative
slim	positive
sloppili	negative
sloppi	negative
sloth	negative
slowli	negative
slow-mov	negative
slow	negative
sluggish	negative
slug	negative
slump	negative
slur	negative
sly	negative
smack	negative
smarter	positive
smartest	positive
smartli	positive
smart	positive
smash	negative
smear	negative
smell	negative
smile	positive
smilingli	positive
smitten	positive
smokescreen	negative
smolder	negative
smooth	positive
smother	negative
smoulder	negative
smugli	negative
smug	negative
smut	negative
smuttier	negative
smuttiest	negative
smutti	negative
snare	negative
snarl	negative
snatch	negative
sneakili	negative
sneaki	negative
sneak	negative
sneeringli	negative
sneer	negative
snub	negative
sober	negative
sob	negative
so-cal	negative
sociabl	positive
soften	positive
soft-spoken	positive
solac	positive
solemn	negative
solicit	positive
solicitud	positive
solidar	positive
solid	positive
soliloqu	neutral
somber	negative
so	neutral
soothingli	positive
sooth	positive
sophist	positive
sore	negative
sorri	negative
sorrowfulli	negative
sorrow	negative
sound	negative
sound	positive
sourli	negative
sour	negative
sovereignti	neutral
spaciou	positive
spade	negative
spank	negative
spare	positive
sparingli	positive
sparkl	positive
special	positive
specif	neutral
spectacularli	positive
spectacular	positive
specul	neutral
speedi	positive
spellbindingli	positive
spellbind	positive
spellbound	positive
spill	negative
spinster	negative
spiritless	negative
spirit	positive
spiritu	positive
spitefulli	negative
spite	negative
splayed-fing	neutral
splendidli	positive
splendid	positive
splendor	positive
split	negative
spoil	negative
spookier	negative
spookiest	negative
spookili	negative
spooki	negative
spook	negative
spoon-fe	negative
spoon-f	negative
spoonf	negative
sporad	negative
spotless	positive
spot	negative
spotti	negative
sprightli	positive
spuriou	negative
spurn	negative
spur	positive
sputter	negative
squabbl	negative
squander	negative
squar	positive
squash	negative
squirm	negative
stabil	positive
stabl	positive
stab	negative
staggeringli	negative
stagger	negative
stagnant	negative
stagnat	negative
staid	negative
stainless	positive
stain	negative
stake	negative
stalem	negative
stale	negative
stammer	negative
stamped	negative
stanc	neutral
stand	neutral
stand	positive
standstil	negative
starkli	negative
stark	negative
star	positive
startlingli	negative
startl	negative
starvat	negative
starv	negative
statement	neutral
state	positive
static	negative
statuesqu	positive
staunchli	positive
staunch	positive
steadfastli	positive
steadfast	positive
steadi	positive
steal	negative
steepli	negative
steep	negative
stellarli	positive
stellar	positive
stench	negative
stereotyp	negative
stern	negative
stew	negative
sticki	negative
stiff	negative
stiflingli	negative
stifl	negative
stigma	negative
stigmat	negative
still	neutral
stimul	positive
stingingli	negative
sting	negative
stink	negative
stir	neutral
stir	positive
stirringli	positive
stodgi	negative
stole	negative
stolen	negative
stood	positive
stoog	negative
stormi	negative
storm	negative
straggler	negative
straggl	negative
straightforward	positive
straight	positive
strain	negative
stranger	negative
strangest	negative
strangl	negative
strang	negative
streamlin	positive
strength	neutral
strenuou	negative
stressfulli	negative
stress	negative
stricken	negative
strictli	negative
strict	negative
strident	negative
stride	positive
strife	negative
strike	negative
strike	positive
strikingli	positive
stringent	negative
strive	positive
stronger-than-expect	neutral
strong	positive
struck	negative
struggl	negative
strut	negative
stubbornli	negative
stubborn	negative
studiou	positive
studious	positive
stuffi	negative
stuf	neutral
stumbl	negative
stump	negative
stun	negative
stunningli	positive
stun	positive
stunt	negative
stupefi	neutral
stupend	positive
stupidli	negative
stupid	negative
stupifi	negative
stupor	negative
sturdi	positive
stylishli	positive
stylish	positive
sty	negative
suav	positive
subdu	negative
subject	negative
subjug	negative
sublim	positive
submiss	negative
subordin	negative
subscrib	positive
subservi	negative
subsid	negative
substandard	negative
substanti	positive
substant	positive
subtl	positive
subtract	negative
subvers	negative
subvert	negative
succe	positive
successfulli	positive
success	positive
succumb	negative
such	neutral
sucker	negative
suffer	negative
suffici	positive
suffic	positive
suffoc	negative
sugar-coat	negative
sugar-co	negative
sugarco	negative
suggest	positive
suicid	negative
suitabl	positive
suit	positive
sulk	negative
sullen	negative
sulli	negative
sumptuou	positive
sumptuous	positive
sunder	negative
sunni	positive
superbl	positive
superb	positive
superfici	negative
superflu	negative
superior	negative
superior	positive
superl	positive
super	positive
superstiti	negative
superstit	negative
support	positive
suppos	negative
suppos	neutral
suppress	negative
supremaci	negative
suprem	positive
supurbl	positive
supurb	positive
sure	positive
surg	positive
surmis	positive
surmount	positive
surpass	positive
surprisingli	neutral
surpris	neutral
surrend	negative
survivor	positive
surviv	positive
suscept	negative
suspect	negative
suspici	negative
suspicion	negative
sustain	positive
swagger	negative
swamp	negative
swear	negative
sweep	positive
sweeten	positive
sweetheart	positive
sweetli	positive
sweet	positive
swift	positive
swindl	negative
swing	neutral
swipe	negative
swoon	negative
swore	negative
sworn	positive
sympathet	negative
sympathi	negative
sympath	negative
symptom	negative
syndrom	negative
systemat	neutral
taboo	negative
tact	positive
taint	negative
tale	neutral
talent	positive
tall	neutral
tamper	negative
tangl	negative
tantalizingli	positive
tantal	positive
tantamount	neutral
tantrum	negative
tardi	negative
tarnish	negative
tast	neutral
tast	positive
tatter	negative
tauntingli	negative
taunt	negative
tawdri	negative
tax	negative
teasingli	negative
teas	negative
tediou	negative
tedious	negative
temer	negative
temper	negative
temper	positive
tempest	negative
temptat	negative
temptingli	positive
tempt	positive
tenaci	positive
tenac	positive
tendenc	neutral
tenderli	positive
tender	positive
tension	negative
tens	negative
tent	negative
tenuou	negative
tenuous	negative
tepid	negative
terribl	negative
terrifi	positive
terrif	positive
terrifyingli	positive
terror-gen	negative
terror	negative
thankfulli	positive
thankless	negative
thank	positive
theoret	neutral
therefor	neutral
thinkabl	positive
think	neutral
thirst	negative
thorni	negative
thorough	positive
though	neutral
thoughtfulli	positive
thoughtlessli	negative
thoughtless	negative
thought	neutral
thought	positive
thrash	negative
threaten	negative
threat	negative
thrifti	positive
thrift	positive
thrillingli	positive
thrill	positive
thrive	positive
throttl	negative
throw	negative
thumb	negative
thu	neutral
thusli	neutral
thwart	negative
tickl	positive
tidi	positive
time-honor	positive
time	positive
timidli	negative
timid	negative
tingl	positive
tini	negative
tint	neutral
tire	negative
tiresom	negative
tiringli	negative
titillatingli	positive
titil	positive
toast	positive
togeth	positive
toil	negative
tolerantli	positive
toler	positive
toll	negative
too	negative
toppl	negative
top	positive
torment	negative
torrent	negative
torridli	positive
torrid	positive
tortuou	negative
tortur	negative
totalitarian	negative
touchi	negative
touch	neutral
tough	negative
toxic	negative
tradit	positive
traduc	negative
tragedi	negative
tragic	negative
traitor	negative
trampl	negative
tramp	negative
tranquil	positive
transgress	negative
transpar	neutral
transport	neutral
trauma	negative
traumat	negative
travesti	negative
treacheri	negative
treacher	negative
treason	negative
treasur	positive
treat	positive
tremend	positive
trendi	positive
trepid	positive
trial	negative
tribut	positive
trickeri	negative
tricki	negative
trick	negative
trim	positive
triumphal	positive
triumphantli	positive
triumphant	positive
triumph	positive
trivial	negative
troublemak	negative
troublesom	negative
troublingli	negative
troubl	negative
truant	negative
trucul	positive
true	positive
truli	positive
trumpet	positive
trump	positive
trustingli	positive
trust	positive
trustworthi	positive
truthfulli	positive
truth	positive
try	negative
tumultu	negative
turbul	negative
turmoil	negative
twinkli	positive
twist	negative
tyranni	negative
tyrann	negative
tyrant	negative
ugh	negative
ugli	negative
ulterior	negative
ultimatum	negative
ultim	positive
ultra-hardlin	negative
ultra	positive
unabashedli	positive
unabash	positive
unabl	negative
unaccept	negative
unaccustom	negative
unanim	positive
unassail	positive
unattract	negative
unaudit	neutral
unauthent	negative
unavail	negative
unavoid	negative
unbear	negative
unbeliev	negative
unbias	positive
unbosom	positive
unbound	positive
unbroken	positive
uncertain	negative
uncivil	negative
unclean	negative
unclear	negative
uncollect	negative
uncomfort	negative
uncommonli	positive
uncommon	positive
uncompetit	negative
uncompromisingli	negative
uncompromis	negative
unconcern	positive
uncondit	positive
unconfirm	negative
unconstitut	negative
uncontrol	negative
unconvent	positive
unconvincingli	negative
unconvinc	negative
uncouth	negative
undaunt	positive
undecid	negative
undefin	negative
undepend	negative
underdog	negative
underestim	negative
underl	negative
undermin	negative
underpaid	negative
understand	positive
understatedli	positive
understood	positive
underst	positive
undesir	negative
undetermin	negative
undid	negative
undignifi	negative
undisput	positive
undocu	negative
undo	negative
undon	negative
undoubtedli	positive
undoubt	positive
undu	negative
uneasili	negative
uneasi	negative
uneas	negative
uneconom	negative
unencumb	positive
unequivoc	positive
unequ	negative
uneth	negative
uneven	negative
unev	negative
unexpectedli	negative
unexpect	negative
unexplain	negative
unfairli	negative
unfair	negative
unfaithfulli	negative
unfaith	negative
unfamiliar	negative
unfavor	negative
unfaz	positive
unfeel	negative
unfett	positive
unfinish	negative
unfit	negative
unforeseen	negative
unforgett	positive
unfortun	negative
unfound	negative
unfriendli	negative
unfulfil	negative
unfund	negative
ungovern	negative
ungrat	negative
unhappili	negative
unhappi	negative
unhealthi	negative
uniformli	positive
uniform	positive
unilater	negative
unimagin	negative
unimport	negative
uninform	negative
uninsur	negative
unipolar	negative
uniqu	positive
uniti	positive
univers	positive
unjustifi	negative
unjustli	negative
unjust	negative
unkindli	negative
unkind	negative
unlament	negative
unlawfulli	negative
unlaw	negative
unleash	negative
unlicens	negative
unlik	negative
unlimit	positive
unlucki	negative
unmov	negative
unnatur	negative
unnecessari	negative
unneed	negative
unnervingli	negative
unnerv	negative
unnot	negative
unobserv	negative
unorthodoxi	negative
unorthodox	negative
unparallel	positive
unpleasantri	negative
unpleas	negative
unpopular	negative
unpreced	negative
unpredict	negative
unprepar	negative
unpretenti	positive
unproduct	negative
unprofit	negative
unqualifi	negative
unquestion	positive
unravel	negative
unrealist	negative
unreason	negative
unrelentingli	negative
unreli	negative
unrel	negative
unresolv	negative
unrest	negative
unrestrict	positive
unruli	negative
unsaf	negative
unsatisfactori	negative
unsavori	negative
unscath	positive
unscrupul	negative
unseemli	negative
unselfish	positive
unsettlingli	negative
unsettl	negative
unskil	negative
unsophist	negative
unsound	negative
unspeak	negative
unspecifi	negative
unstabl	negative
unsteadili	negative
unsteadi	negative
unsuccessfulli	negative
unsuccess	negative
unsupport	negative
unsur	negative
unsuspect	negative
unsustain	negative
unten	negative
untest	negative
unthink	negative
untim	negative
untouch	positive
untrain	positive
untru	negative
untrustworthi	negative
untruth	negative
unusu	negative
unwant	negative
unwarr	negative
unwelcom	negative
unwieldi	negative
unwillingli	negative
unwilling	negative
unwil	negative
unwis	negative
unwork	negative
unworthi	negative
unyield	negative
upbeat	positive
upbraid	negative
upfront	positive
upgrad	positive
upheav	negative
upheld	positive
uphold	positive
upliftingli	positive
uplift	positive
upright	positive
upris	negative
uproari	negative
uproar	negative
uproot	negative
upscal	positive
upset	negative
upsettingli	negative
upsid	positive
upward	positive
urgenc	negative
urgent	negative
urg	positive
usabl	positive
useless	negative
us	positive
usurp	negative
utilitarian	positive
utmost	positive
utterli	negative
uttermost	positive
utter	negative
utter	neutral
vagrant	negative
vagu	negative
vainli	negative
vain	negative
valiantli	positive
valiant	positive
valid	positive
valor	positive
valuabl	positive
valu	positive
vanish	negative
vaniti	negative
vanquish	positive
vastli	positive
vast	positive
vehement	negative
vener	positive
vengeanc	negative
vengefulli	negative
veng	negative
venom	negative
vent	negative
verifi	positive
veri	neutral
verit	positive
versatil	positive
vestig	negative
veto	negative
vexat	negative
vexingli	negative
vex	negative
viabil	positive
viabl	positive
vibrantli	positive
vibrant	positive
vice	negative
viciou	negative
vicious	negative
victim	negative
victori	positive
vie	negative
view	neutral
viewpoint	neutral
vigil	positive
vigor	positive
vile	negative
vilifi	negative
villain	negative
villian	negative
villifi	negative
vindic	positive
vindict	negative
vintag	positive
violat	negative
violent	negative
viper	negative
virtuou	positive
virtuous	positive
virtu	positive
virul	negative
viru	negative
visionari	positive
vital	positive
vivaci	positive
vivid	positive
vocal	negative
vocal	neutral
vocifer	negative
void	negative
volatil	negative
voluntarili	positive
voluntari	positive
vomit	negative
vouch	positive
vouchsaf	positive
vow	positive
vulgar	negative
vulner	positive
wail	negative
wallow	negative
wane	negative
wanton	negative
want	positive
warfar	negative
warili	negative
wari	negative
war-lik	negative
warlik	negative
warmheart	positive
warmli	positive
warm	positive
warmth	positive
war	negative
warn	negative
warp	negative
wast	negative
watchdog	negative
wayward	negative
weaken	negative
weak	negative
wealthi	positive
weari	negative
wearisom	negative
wedg	negative
weed	negative
wee	negative
weep	negative
weirdli	negative
weird	negative
welcom	positive
welfar	positive
well-b	positive
wellb	positive
well-connect	positive
well-educ	positive
well-establish	positive
well-inform	positive
well-intent	positive
well-manag	positive
well	positive
well-posit	positive
well-public	positive
well-receiv	positive
well-regard	positive
well-run	positive
well-wish	positive
whatev	negative
wheedl	negative
whiff	neutral
whimper	negative
whimsic	positive
whine	negative
whip	negative
white	positive
wholeheartedli	positive
wholesom	positive
wickedli	negative
wicked	negative
wick	negative
wide-open	positive
wide	positive
wide-rang	positive
widespread	negative
wildli	negative
wild	negative
wile	negative
wili	negative
willfulli	positive
willing	positive
will	positive
wilt	negative
winc	negative
wink	positive
winnabl	positive
winner	positive
wisdom	positive
wise	positive
wish	positive
withheld	negative
withhold	negative
witti	positive
woebegon	negative
woefulli	negative
woeful	negative
woe	negative
wonderfulli	positive
wonder	positive
wondrou	positive
woo	positive
workabl	positive
world-fam	positive
worn	negative
worriedli	negative
worrier	negative
worri	negative
worrisom	negative
worryingli	negative
worsen	negative
worship	positive
wors	negative
worst	negative
worthi	positive
worthlessli	negative
worthless	negative
worth	positive
worth-whil	positive
worthwhil	positive
would	neutral
wound	negative
wow	positive
wrangl	negative
wrath	negative
wreck	negative
wrestl	negative
wrest	negative
wretchedli	negative
wretched	negative
wretch	negative
writh	negative
wrongli	negative
wrong	negative
wrought	negative
wry	positive
yawn	negative
yeah	neutral
yearningli	positive
yearn	positive
yelp	negative
ye	positive
yep	positive
youth	positive
zealot	negative
zealou	negative
zealous	negative
zeal	positive
zenith	positive
zest	positive
